20
29
1
1
11111111111111111111111111111
10111111111110000000001111111
10111111111111011111101111111
10000000000000000000001111111
11111111111111101111111111111
11111111111111101111111111111
11111111111111101111111111111
10000000000000000000000000001
11111111111111101111111111111
10000000000000000000000000001
11111111111111111110111111111
10000000000000000000000000001
00111111111111111111111111111
10000000000000000000111111111
11111111010110111011111111111
11111100000000000000000000000
11111111011111111111111111111
11111111011111111111111111111
11111100000011111111111111111
11111111011011111111111111111